111111111111111
100000P0C001001
1100C0100010C01
11100E110C00101
111111111111111