111111111111111
100000p0000c001
110000c000c0001
11100e110000c01
111111111111111