1111111111111111
10000011P1111001
10000111C1001011
11111111E1111111
1001010111001011
1111111111111111