1111111111
1E0001C101
1000000001
1000010001
11C00C1111
10C0P00C01
1111111111