1111111111
1E000C1001
1000011001
11C00C0001
1110P00C01
1000110011
1C00000111
1111101111
1CCCCCCCC1
1111111111