1111111111111111
1000C00000111001
10000000P0001011
1111000001111111
1E00010111001011
1111111111111111