111111111111111111111
1EP000000000000000001
111111111111111111101
100000000000000000001
101111111111111111111
1000000000000000000C1
111111111111111111111