1111111111111111
1P00CN00NC1110C1
100C0000C0001011
1111000001000011
100C0000C0001011
1111000001000011
1E00010111N01C11
1111111111111111