1111111111111111111111111
1P00000101110000100010011
11111101000001
10000000010101
101011110
10100001
11111101
1
1
1
1
1
1
11111111111111111111111111