11111111111111111111111111111111
1N00NNNNN00NN000C00N00N00NPNNN01
1NN0NC000N00N0N0N00N00N0NNCN0N01
10N0NNN0NN0NN0N0NN0N0NN0N00N0NN1
1NN000N0N00N00N00N0NNN00NN0N0001
1N0NNNN0NNNNN0N00N000NNN000NNN01
1NNN0000000000NN0NNN00000N000NN1
1NNN00NN0NNNNN0N000NNNNN0NNN00N1
1000NNN00000000NNNN0000N000NN0N1
1NN0N0N0N0NNNNN000N0NNNN0N00N0N1
10N0N0NNN0N0N0000NN000N00NN0N0N1
1NN0N00000N0N0NNNN000NN00N00NNN1
1N000N0000N00NNN00N00N0000000NN1
10NN000NN0NNN00NN0NNNN0NNNN000N1
1N0000N0NC00N0N0NN0000NN00N0NNN1
1N0NCNN0NNN0N0N00NNNNNN000N0N001
1N0NN00NN000N0C000NNN0NN0NN0N0N1
1C00000N0NNNN0N00000000N0N00NNN1
1N0N0NNN000N00NNNN0NNN000NN000N1
1NNN0000000000NNNN0N0NN000CNNEN1
11111111111111111111111111111111