11111111111111111111111111111111
11001N1110011000C00100100101P101
1110NC000N0010101001001011C10101
10101N101101101011010110100N0111
11100010N00100100101110011000001
11011110111110100100011100011101
11N1000000000011011N000001000111
11110011011111010001111101110011
10001110000000011110000100011011
11101010101111N00010111101001011
10101011101010000110001001101011
11101000001010111100011001001N11
11000100001001110010010000000111
10110001101110011011110111100011
110000101C0010101100001100101111
1101CN1011101010011N111000101001
110110011000N0C00011101101101011
1C000001011110100000000101001111
11010111000100111101110001100011
1111000000000C1NN101011000C11E11
11111111111111111111111111111111